cache.any.documents.parse_failures: cache_name=dynamic-config-client-updater	GAUGE	0
cache.any.documents.parse_failures: cache_name=sample-cache	GAUGE	0
cache.any.documents.read_count: cache_name=dynamic-config-client-updater	GAUGE	0
cache.any.documents.read_count: cache_name=sample-cache	GAUGE	0
cache.any.documents.parse_failures.v2: cache_name=dynamic-config-client-updater	RATE	0
cache.any.documents.parse_failures.v2: cache_name=sample-cache	RATE	0
cache.any.documents.read_count.v2: cache_name=dynamic-config-client-updater	RATE	0
cache.any.documents.read_count.v2: cache_name=sample-cache	RATE	0
cache.any.time.last-update-duration-ms: cache_name=dynamic-config-client-updater	GAUGE	0
cache.any.time.last-update-duration-ms: cache_name=sample-cache	GAUGE	0
cache.any.time.time-from-last-successful-start-ms: cache_name=dynamic-config-client-updater	GAUGE	0
cache.any.time.time-from-last-successful-start-ms: cache_name=sample-cache	GAUGE	0
cache.any.time.time-from-last-update-start-ms: cache_name=dynamic-config-client-updater	GAUGE	0
cache.any.time.time-from-last-update-start-ms: cache_name=sample-cache	GAUGE	0
cache.any.update.attempts_count: cache_name=dynamic-config-client-updater	GAUGE	0
cache.any.update.attempts_count: cache_name=sample-cache	GAUGE	0
cache.any.update.failures_count: cache_name=dynamic-config-client-updater	GAUGE	0
cache.any.update.failures_count: cache_name=sample-cache	GAUGE	0
cache.any.update.no_changes_count: cache_name=dynamic-config-client-updater	GAUGE	0
cache.any.update.no_changes_count: cache_name=sample-cache	GAUGE	0
cache.any.update.attempts_count.v2: cache_name=dynamic-config-client-updater	RATE	0
cache.any.update.attempts_count.v2: cache_name=sample-cache	RATE	0
cache.any.update.failures_count.v2: cache_name=dynamic-config-client-updater	RATE	0
cache.any.update.failures_count.v2: cache_name=sample-cache	RATE	0
cache.any.update.no_changes_count.v2: cache_name=dynamic-config-client-updater	RATE	0
cache.any.update.no_changes_count.v2: cache_name=sample-cache	RATE	0
cache.background-updates: cache_name=sample-lru-cache	GAUGE	0
cache.current-documents-count: cache_name=dynamic-config-client-updater	GAUGE	0
cache.current-documents-count: cache_name=sample-cache	GAUGE	0
cache.current-documents-count: cache_name=sample-lru-cache	GAUGE	0
cache.dump.is-current-from-dump: cache_name=sample-cache	GAUGE	0
cache.dump.is-loaded-from-dump: cache_name=sample-cache	GAUGE	0
cache.full.documents.parse_failures: cache_name=dynamic-config-client-updater	GAUGE	0
cache.full.documents.parse_failures: cache_name=sample-cache	GAUGE	0
cache.full.documents.read_count: cache_name=dynamic-config-client-updater	GAUGE	0
cache.full.documents.read_count: cache_name=sample-cache	GAUGE	0
cache.full.documents.parse_failures.v2: cache_name=dynamic-config-client-updater	RATE	0
cache.full.documents.parse_failures.v2: cache_name=sample-cache	RATE	0
cache.full.documents.read_count.v2: cache_name=dynamic-config-client-updater	RATE	0
cache.full.documents.read_count.v2: cache_name=sample-cache	RATE	0
cache.full.time.last-update-duration-ms: cache_name=dynamic-config-client-updater	GAUGE	0
cache.full.time.last-update-duration-ms: cache_name=sample-cache	GAUGE	0
cache.full.time.time-from-last-successful-start-ms: cache_name=dynamic-config-client-updater	GAUGE	0
cache.full.time.time-from-last-successful-start-ms: cache_name=sample-cache	GAUGE	0
cache.full.time.time-from-last-update-start-ms: cache_name=dynamic-config-client-updater	GAUGE	0
cache.full.time.time-from-last-update-start-ms: cache_name=sample-cache	GAUGE	0
cache.full.update.attempts_count: cache_name=dynamic-config-client-updater	GAUGE	0
cache.full.update.attempts_count: cache_name=sample-cache	GAUGE	0
cache.full.update.failures_count: cache_name=dynamic-config-client-updater	GAUGE	0
cache.full.update.failures_count: cache_name=sample-cache	GAUGE	0
cache.full.update.no_changes_count: cache_name=dynamic-config-client-updater	GAUGE	0
cache.full.update.no_changes_count: cache_name=sample-cache	GAUGE	0
cache.full.update.attempts_count.v2: cache_name=dynamic-config-client-updater	RATE	0
cache.full.update.attempts_count.v2: cache_name=sample-cache	RATE	0
cache.full.update.failures_count.v2: cache_name=dynamic-config-client-updater	RATE	0
cache.full.update.failures_count.v2: cache_name=sample-cache	RATE	0
cache.full.update.no_changes_count.v2: cache_name=dynamic-config-client-updater	RATE	0
cache.full.update.no_changes_count.v2: cache_name=sample-cache	RATE	0
cache.hit_ratio.1min: cache_name=sample-lru-cache	GAUGE	0
cache.hits: cache_name=sample-lru-cache	GAUGE	0
cache.incremental.documents.parse_failures: cache_name=dynamic-config-client-updater	GAUGE	0
cache.incremental.documents.parse_failures: cache_name=sample-cache	GAUGE	0
cache.incremental.documents.read_count: cache_name=dynamic-config-client-updater	GAUGE	0
cache.incremental.documents.read_count: cache_name=sample-cache	GAUGE	0
cache.incremental.documents.parse_failures.v2: cache_name=dynamic-config-client-updater	RATE	0
cache.incremental.documents.parse_failures.v2: cache_name=sample-cache	RATE	0
cache.incremental.documents.read_count.v2: cache_name=dynamic-config-client-updater	RATE	0
cache.incremental.documents.read_count.v2: cache_name=sample-cache	RATE	0
cache.incremental.time.last-update-duration-ms: cache_name=dynamic-config-client-updater	GAUGE	0
cache.incremental.time.last-update-duration-ms: cache_name=sample-cache	GAUGE	0
cache.incremental.time.time-from-last-successful-start-ms: cache_name=dynamic-config-client-updater	GAUGE	0
cache.incremental.time.time-from-last-successful-start-ms: cache_name=sample-cache	GAUGE	0
cache.incremental.time.time-from-last-update-start-ms: cache_name=dynamic-config-client-updater	GAUGE	0
cache.incremental.time.time-from-last-update-start-ms: cache_name=sample-cache	GAUGE	0
cache.incremental.update.attempts_count: cache_name=dynamic-config-client-updater	GAUGE	0
cache.incremental.update.attempts_count: cache_name=sample-cache	GAUGE	0
cache.incremental.update.failures_count: cache_name=dynamic-config-client-updater	GAUGE	0
cache.incremental.update.failures_count: cache_name=sample-cache	GAUGE	0
cache.incremental.update.no_changes_count: cache_name=dynamic-config-client-updater	GAUGE	0
cache.incremental.update.no_changes_count: cache_name=sample-cache	GAUGE	0
cache.incremental.update.attempts_count.v2: cache_name=dynamic-config-client-updater	RATE	0
cache.incremental.update.attempts_count.v2: cache_name=sample-cache	RATE	0
cache.incremental.update.failures_count.v2: cache_name=dynamic-config-client-updater	RATE	0
cache.incremental.update.failures_count.v2: cache_name=sample-cache	RATE	0
cache.incremental.update.no_changes_count.v2: cache_name=dynamic-config-client-updater	RATE	0
cache.incremental.update.no_changes_count.v2: cache_name=sample-cache	RATE	0
cache.misses: cache_name=sample-lru-cache	GAUGE	0
cache.stale: cache_name=sample-lru-cache	GAUGE	0
congestion-control.rps.is-custom-status-activated:	GAUGE	0
cpu_time_sec:	GAUGE	0
dns-client.replies: dns_reply_source=cached	GAUGE	0
dns-client.replies: dns_reply_source=cached-failure	GAUGE	0
dns-client.replies: dns_reply_source=cached-stale	GAUGE	0
dns-client.replies: dns_reply_source=file	GAUGE	0
dns-client.replies: dns_reply_source=network	GAUGE	0
dns-client.replies: dns_reply_source=network-failure	GAUGE	0
dynamic-config.parse-errors:	RATE	0
dynamic-config.was-last-parse-successful:	GAUGE	0
engine.coro-pool.coroutines.active:	GAUGE	0
engine.coro-pool.coroutines.total:	GAUGE	0
engine.ev-threads.cpu-load-percent: ev_thread_name=event-worker_0	GAUGE	0
engine.ev-threads.cpu-load-percent: ev_thread_name=event-worker_1	GAUGE	0
engine.load-ms:	GAUGE	0
engine.task-processors-load-percent: task_processor=fs-task-processor, thread=0	GAUGE	0
engine.task-processors-load-percent: task_processor=fs-task-processor, thread=1	GAUGE	0
engine.task-processors-load-percent: task_processor=main-task-processor, thread=0	GAUGE	0
engine.task-processors-load-percent: task_processor=main-task-processor, thread=1	GAUGE	0
engine.task-processors-load-percent: task_processor=main-task-processor, thread=2	GAUGE	0
engine.task-processors-load-percent: task_processor=main-task-processor, thread=3	GAUGE	0
engine.task-processors-load-percent: task_processor=main-task-processor, thread=4	GAUGE	0
engine.task-processors-load-percent: task_processor=main-task-processor, thread=5	GAUGE	0
engine.task-processors-load-percent: task_processor=monitor-task-processor, thread=0	GAUGE	0
engine.task-processors.context_switch.fast: task_processor=fs-task-processor	GAUGE	0
engine.task-processors.context_switch.fast: task_processor=main-task-processor	GAUGE	0
engine.task-processors.context_switch.fast: task_processor=monitor-task-processor	GAUGE	0
engine.task-processors.context_switch.no_overloaded: task_processor=fs-task-processor	GAUGE	0
engine.task-processors.context_switch.no_overloaded: task_processor=main-task-processor	GAUGE	0
engine.task-processors.context_switch.no_overloaded: task_processor=monitor-task-processor	GAUGE	0
engine.task-processors.context_switch.overloaded: task_processor=fs-task-processor	GAUGE	0
engine.task-processors.context_switch.overloaded: task_processor=main-task-processor	GAUGE	0
engine.task-processors.context_switch.overloaded: task_processor=monitor-task-processor	GAUGE	0
engine.task-processors.context_switch.slow: task_processor=fs-task-processor	GAUGE	0
engine.task-processors.context_switch.slow: task_processor=main-task-processor	GAUGE	0
engine.task-processors.context_switch.slow: task_processor=monitor-task-processor	GAUGE	0
engine.task-processors.context_switch.spurious_wakeups: task_processor=fs-task-processor	GAUGE	0
engine.task-processors.context_switch.spurious_wakeups: task_processor=main-task-processor	GAUGE	0
engine.task-processors.context_switch.spurious_wakeups: task_processor=monitor-task-processor	GAUGE	0
engine.task-processors.errors: task_processor=fs-task-processor, task_processor_error=wait_queue_overload	GAUGE	0
engine.task-processors.errors: task_processor=main-task-processor, task_processor_error=wait_queue_overload	GAUGE	0
engine.task-processors.errors: task_processor=monitor-task-processor, task_processor_error=wait_queue_overload	GAUGE	0
engine.task-processors.tasks.alive: task_processor=fs-task-processor	GAUGE	0
engine.task-processors.tasks.alive: task_processor=main-task-processor	GAUGE	0
engine.task-processors.tasks.alive: task_processor=monitor-task-processor	GAUGE	0
engine.task-processors.tasks.cancelled: task_processor=fs-task-processor	GAUGE	0
engine.task-processors.tasks.cancelled: task_processor=main-task-processor	GAUGE	0
engine.task-processors.tasks.cancelled: task_processor=monitor-task-processor	GAUGE	0
engine.task-processors.tasks.cancelled_overload: task_processor=fs-task-processor	GAUGE	0
engine.task-processors.tasks.cancelled_overload: task_processor=main-task-processor	GAUGE	0
engine.task-processors.tasks.cancelled_overload: task_processor=monitor-task-processor	GAUGE	0
engine.task-processors.tasks.created: task_processor=fs-task-processor	GAUGE	0
engine.task-processors.tasks.created: task_processor=main-task-processor	GAUGE	0
engine.task-processors.tasks.created: task_processor=monitor-task-processor	GAUGE	0
engine.task-processors.tasks.finished: task_processor=fs-task-processor	GAUGE	0
engine.task-processors.tasks.finished: task_processor=main-task-processor	GAUGE	0
engine.task-processors.tasks.finished: task_processor=monitor-task-processor	GAUGE	0
engine.task-processors.tasks.queued: task_processor=fs-task-processor	GAUGE	0
engine.task-processors.tasks.queued: task_processor=main-task-processor	GAUGE	0
engine.task-processors.tasks.queued: task_processor=monitor-task-processor	GAUGE	0
engine.task-processors.tasks.running: task_processor=fs-task-processor	GAUGE	0
engine.task-processors.tasks.running: task_processor=main-task-processor	GAUGE	0
engine.task-processors.tasks.running: task_processor=monitor-task-processor	GAUGE	0
engine.task-processors.worker-threads: task_processor=fs-task-processor	GAUGE	0
engine.task-processors.worker-threads: task_processor=main-task-processor	GAUGE	0
engine.task-processors.worker-threads: task_processor=monitor-task-processor	GAUGE	0
engine.uptime-seconds:	GAUGE	0
http.by-fallback.implicit-http-options.handler.cancelled-by-deadline: http_handler=handler-implicit-http-options, version=2	RATE	0
http.by-fallback.implicit-http-options.handler.deadline-received: http_handler=handler-implicit-http-options, version=2	RATE	0
http.by-fallback.implicit-http-options.handler.in-flight: http_handler=handler-implicit-http-options, version=2	GAUGE	0
http.by-fallback.implicit-http-options.handler.rate-limit-reached: http_handler=handler-implicit-http-options, version=2	RATE	0
http.by-fallback.implicit-http-options.handler.reply-codes: http_code=300, http_handler=handler-implicit-http-options, version=2	RATE	0
http.by-fallback.implicit-http-options.handler.reply-codes: http_code=500, http_handler=handler-implicit-http-options, version=2	RATE	0
http.by-fallback.implicit-http-options.handler.reply-codes: http_code=501, http_handler=handler-implicit-http-options, version=2	RATE	0
http.by-fallback.implicit-http-options.handler.rps: http_handler=handler-implicit-http-options, version=2	RATE	0
http.by-fallback.implicit-http-options.handler.timings: http_handler=handler-implicit-http-options, percentile=p0, version=2	GAUGE	0
http.by-fallback.implicit-http-options.handler.timings: http_handler=handler-implicit-http-options, percentile=p100, version=2	GAUGE	0
http.by-fallback.implicit-http-options.handler.timings: http_handler=handler-implicit-http-options, percentile=p50, version=2	GAUGE	0
http.by-fallback.implicit-http-options.handler.timings: http_handler=handler-implicit-http-options, percentile=p90, version=2	GAUGE	0
http.by-fallback.implicit-http-options.handler.timings: http_handler=handler-implicit-http-options, percentile=p95, version=2	GAUGE	0
http.by-fallback.implicit-http-options.handler.timings: http_handler=handler-implicit-http-options, percentile=p98, version=2	GAUGE	0
http.by-fallback.implicit-http-options.handler.timings: http_handler=handler-implicit-http-options, percentile=p99, version=2	GAUGE	0
http.by-fallback.implicit-http-options.handler.timings: http_handler=handler-implicit-http-options, percentile=p99_6, version=2	GAUGE	0
http.by-fallback.implicit-http-options.handler.timings: http_handler=handler-implicit-http-options, percentile=p99_9, version=2	GAUGE	0
http.by-fallback.implicit-http-options.handler.too-many-requests-in-flight: http_handler=handler-implicit-http-options, version=2	RATE	0
http.handler.cancelled-by-deadline: http_handler=handler-dns-client-control, http_path=/service/dnsclient/_command_, version=2	RATE	0
http.handler.cancelled-by-deadline: http_handler=handler-dynamic-debug-log, http_path=/service/log/dynamic-debug, version=2	RATE	0
http.handler.cancelled-by-deadline: http_handler=handler-inspect-requests, http_path=/service/inspect-requests, version=2	RATE	0
http.handler.cancelled-by-deadline: http_handler=handler-jemalloc, http_path=/service/jemalloc/prof/_command_, version=2	RATE	0
http.handler.cancelled-by-deadline: http_handler=handler-log-level, http_path=/service/log-level/_level_, version=2	RATE	0
http.handler.cancelled-by-deadline: http_handler=handler-on-log-rotate, http_path=/service/on-log-rotate/, version=2	RATE	0
http.handler.cancelled-by-deadline: http_handler=handler-ping, http_path=/ping, version=2	RATE	0
http.handler.cancelled-by-deadline: http_handler=handler-server-monitor, http_path=/service/monitor, version=2	RATE	0
http.handler.cancelled-by-deadline: http_handler=tests-control, http_path=/tests/_action_, version=2	RATE	0
http.handler.deadline-received: http_handler=handler-dns-client-control, http_path=/service/dnsclient/_command_, version=2	RATE	0
http.handler.deadline-received: http_handler=handler-dynamic-debug-log, http_path=/service/log/dynamic-debug, version=2	RATE	0
http.handler.deadline-received: http_handler=handler-inspect-requests, http_path=/service/inspect-requests, version=2	RATE	0
http.handler.deadline-received: http_handler=handler-jemalloc, http_path=/service/jemalloc/prof/_command_, version=2	RATE	0
http.handler.deadline-received: http_handler=handler-log-level, http_path=/service/log-level/_level_, version=2	RATE	0
http.handler.deadline-received: http_handler=handler-on-log-rotate, http_path=/service/on-log-rotate/, version=2	RATE	0
http.handler.deadline-received: http_handler=handler-ping, http_path=/ping, version=2	RATE	0
http.handler.deadline-received: http_handler=handler-server-monitor, http_path=/service/monitor, version=2	RATE	0
http.handler.deadline-received: http_handler=tests-control, http_path=/tests/_action_, version=2	RATE	0
http.handler.in-flight: http_handler=handler-dns-client-control, http_path=/service/dnsclient/_command_, version=2	GAUGE	0
http.handler.in-flight: http_handler=handler-dynamic-debug-log, http_path=/service/log/dynamic-debug, version=2	GAUGE	0
http.handler.in-flight: http_handler=handler-inspect-requests, http_path=/service/inspect-requests, version=2	GAUGE	0
http.handler.in-flight: http_handler=handler-jemalloc, http_path=/service/jemalloc/prof/_command_, version=2	GAUGE	0
http.handler.in-flight: http_handler=handler-log-level, http_path=/service/log-level/_level_, version=2	GAUGE	0
http.handler.in-flight: http_handler=handler-on-log-rotate, http_path=/service/on-log-rotate/, version=2	GAUGE	0
http.handler.in-flight: http_handler=handler-ping, http_path=/ping, version=2	GAUGE	0
http.handler.in-flight: http_handler=handler-server-monitor, http_path=/service/monitor, version=2	GAUGE	0
http.handler.in-flight: http_handler=tests-control, http_path=/tests/_action_, version=2	GAUGE	0
http.handler.rate-limit-reached: http_handler=handler-dns-client-control, http_path=/service/dnsclient/_command_, version=2	RATE	0
http.handler.rate-limit-reached: http_handler=handler-dynamic-debug-log, http_path=/service/log/dynamic-debug, version=2	RATE	0
http.handler.rate-limit-reached: http_handler=handler-inspect-requests, http_path=/service/inspect-requests, version=2	RATE	0
http.handler.rate-limit-reached: http_handler=handler-jemalloc, http_path=/service/jemalloc/prof/_command_, version=2	RATE	0
http.handler.rate-limit-reached: http_handler=handler-log-level, http_path=/service/log-level/_level_, version=2	RATE	0
http.handler.rate-limit-reached: http_handler=handler-on-log-rotate, http_path=/service/on-log-rotate/, version=2	RATE	0
http.handler.rate-limit-reached: http_handler=handler-ping, http_path=/ping, version=2	RATE	0
http.handler.rate-limit-reached: http_handler=handler-server-monitor, http_path=/service/monitor, version=2	RATE	0
http.handler.rate-limit-reached: http_handler=tests-control, http_path=/tests/_action_, version=2	RATE	0
http.handler.reply-codes: http_code=200, http_handler=handler-ping, http_path=/ping, version=2	RATE	0
http.handler.reply-codes: http_code=200, http_handler=handler-server-monitor, http_path=/service/monitor, version=2	RATE	0
http.handler.reply-codes: http_code=200, http_handler=tests-control, http_path=/tests/_action_, version=2	RATE	0
http.handler.reply-codes: http_code=300, http_handler=handler-dns-client-control, http_path=/service/dnsclient/_command_, version=2	RATE	0
http.handler.reply-codes: http_code=300, http_handler=handler-dynamic-debug-log, http_path=/service/log/dynamic-debug, version=2	RATE	0
http.handler.reply-codes: http_code=300, http_handler=handler-inspect-requests, http_path=/service/inspect-requests, version=2	RATE	0
http.handler.reply-codes: http_code=300, http_handler=handler-jemalloc, http_path=/service/jemalloc/prof/_command_, version=2	RATE	0
http.handler.reply-codes: http_code=300, http_handler=handler-log-level, http_path=/service/log-level/_level_, version=2	RATE	0
http.handler.reply-codes: http_code=300, http_handler=handler-on-log-rotate, http_path=/service/on-log-rotate/, version=2	RATE	0
http.handler.reply-codes: http_code=300, http_handler=handler-ping, http_path=/ping, version=2	RATE	0
http.handler.reply-codes: http_code=300, http_handler=handler-server-monitor, http_path=/service/monitor, version=2	RATE	0
http.handler.reply-codes: http_code=300, http_handler=tests-control, http_path=/tests/_action_, version=2	RATE	0
http.handler.reply-codes: http_code=500, http_handler=handler-dns-client-control, http_path=/service/dnsclient/_command_, version=2	RATE	0
http.handler.reply-codes: http_code=500, http_handler=handler-dynamic-debug-log, http_path=/service/log/dynamic-debug, version=2	RATE	0
http.handler.reply-codes: http_code=500, http_handler=handler-inspect-requests, http_path=/service/inspect-requests, version=2	RATE	0
http.handler.reply-codes: http_code=500, http_handler=handler-jemalloc, http_path=/service/jemalloc/prof/_command_, version=2	RATE	0
http.handler.reply-codes: http_code=500, http_handler=handler-log-level, http_path=/service/log-level/_level_, version=2	RATE	0
http.handler.reply-codes: http_code=500, http_handler=handler-on-log-rotate, http_path=/service/on-log-rotate/, version=2	RATE	0
http.handler.reply-codes: http_code=500, http_handler=handler-ping, http_path=/ping, version=2	RATE	0
http.handler.reply-codes: http_code=500, http_handler=handler-server-monitor, http_path=/service/monitor, version=2	RATE	0
http.handler.reply-codes: http_code=500, http_handler=tests-control, http_path=/tests/_action_, version=2	RATE	0
http.handler.reply-codes: http_code=501, http_handler=handler-dns-client-control, http_path=/service/dnsclient/_command_, version=2	RATE	0
http.handler.reply-codes: http_code=501, http_handler=handler-dynamic-debug-log, http_path=/service/log/dynamic-debug, version=2	RATE	0
http.handler.reply-codes: http_code=501, http_handler=handler-inspect-requests, http_path=/service/inspect-requests, version=2	RATE	0
http.handler.reply-codes: http_code=501, http_handler=handler-jemalloc, http_path=/service/jemalloc/prof/_command_, version=2	RATE	0
http.handler.reply-codes: http_code=501, http_handler=handler-log-level, http_path=/service/log-level/_level_, version=2	RATE	0
http.handler.reply-codes: http_code=501, http_handler=handler-on-log-rotate, http_path=/service/on-log-rotate/, version=2	RATE	0
http.handler.reply-codes: http_code=501, http_handler=handler-ping, http_path=/ping, version=2	RATE	0
http.handler.reply-codes: http_code=501, http_handler=handler-server-monitor, http_path=/service/monitor, version=2	RATE	0
http.handler.reply-codes: http_code=501, http_handler=tests-control, http_path=/tests/_action_, version=2	RATE	0
http.handler.rps: http_handler=handler-dns-client-control, http_path=/service/dnsclient/_command_, version=2	RATE	0
http.handler.rps: http_handler=handler-dynamic-debug-log, http_path=/service/log/dynamic-debug, version=2	RATE	0
http.handler.rps: http_handler=handler-inspect-requests, http_path=/service/inspect-requests, version=2	RATE	0
http.handler.rps: http_handler=handler-jemalloc, http_path=/service/jemalloc/prof/_command_, version=2	RATE	0
http.handler.rps: http_handler=handler-log-level, http_path=/service/log-level/_level_, version=2	RATE	0
http.handler.rps: http_handler=handler-on-log-rotate, http_path=/service/on-log-rotate/, version=2	RATE	0
http.handler.rps: http_handler=handler-ping, http_path=/ping, version=2	RATE	0
http.handler.rps: http_handler=handler-server-monitor, http_path=/service/monitor, version=2	RATE	0
http.handler.rps: http_handler=tests-control, http_path=/tests/_action_, version=2	RATE	0
http.handler.timings: http_handler=handler-dns-client-control, http_path=/service/dnsclient/_command_, percentile=p0, version=2	GAUGE	0
http.handler.timings: http_handler=handler-dns-client-control, http_path=/service/dnsclient/_command_, percentile=p100, version=2	GAUGE	0
http.handler.timings: http_handler=handler-dns-client-control, http_path=/service/dnsclient/_command_, percentile=p50, version=2	GAUGE	0
http.handler.timings: http_handler=handler-dns-client-control, http_path=/service/dnsclient/_command_, percentile=p90, version=2	GAUGE	0
http.handler.timings: http_handler=handler-dns-client-control, http_path=/service/dnsclient/_command_, percentile=p95, version=2	GAUGE	0
http.handler.timings: http_handler=handler-dns-client-control, http_path=/service/dnsclient/_command_, percentile=p98, version=2	GAUGE	0
http.handler.timings: http_handler=handler-dns-client-control, http_path=/service/dnsclient/_command_, percentile=p99, version=2	GAUGE	0
http.handler.timings: http_handler=handler-dns-client-control, http_path=/service/dnsclient/_command_, percentile=p99_6, version=2	GAUGE	0
http.handler.timings: http_handler=handler-dns-client-control, http_path=/service/dnsclient/_command_, percentile=p99_9, version=2	GAUGE	0
http.handler.timings: http_handler=handler-dynamic-debug-log, http_path=/service/log/dynamic-debug, percentile=p0, version=2	GAUGE	0
http.handler.timings: http_handler=handler-dynamic-debug-log, http_path=/service/log/dynamic-debug, percentile=p100, version=2	GAUGE	0
http.handler.timings: http_handler=handler-dynamic-debug-log, http_path=/service/log/dynamic-debug, percentile=p50, version=2	GAUGE	0
http.handler.timings: http_handler=handler-dynamic-debug-log, http_path=/service/log/dynamic-debug, percentile=p90, version=2	GAUGE	0
http.handler.timings: http_handler=handler-dynamic-debug-log, http_path=/service/log/dynamic-debug, percentile=p95, version=2	GAUGE	0
http.handler.timings: http_handler=handler-dynamic-debug-log, http_path=/service/log/dynamic-debug, percentile=p98, version=2	GAUGE	0
http.handler.timings: http_handler=handler-dynamic-debug-log, http_path=/service/log/dynamic-debug, percentile=p99, version=2	GAUGE	0
http.handler.timings: http_handler=handler-dynamic-debug-log, http_path=/service/log/dynamic-debug, percentile=p99_6, version=2	GAUGE	0
http.handler.timings: http_handler=handler-dynamic-debug-log, http_path=/service/log/dynamic-debug, percentile=p99_9, version=2	GAUGE	0
http.handler.timings: http_handler=handler-inspect-requests, http_path=/service/inspect-requests, percentile=p0, version=2	GAUGE	0
http.handler.timings: http_handler=handler-inspect-requests, http_path=/service/inspect-requests, percentile=p100, version=2	GAUGE	0
http.handler.timings: http_handler=handler-inspect-requests, http_path=/service/inspect-requests, percentile=p50, version=2	GAUGE	0
http.handler.timings: http_handler=handler-inspect-requests, http_path=/service/inspect-requests, percentile=p90, version=2	GAUGE	0
http.handler.timings: http_handler=handler-inspect-requests, http_path=/service/inspect-requests, percentile=p95, version=2	GAUGE	0
http.handler.timings: http_handler=handler-inspect-requests, http_path=/service/inspect-requests, percentile=p98, version=2	GAUGE	0
http.handler.timings: http_handler=handler-inspect-requests, http_path=/service/inspect-requests, percentile=p99, version=2	GAUGE	0
http.handler.timings: http_handler=handler-inspect-requests, http_path=/service/inspect-requests, percentile=p99_6, version=2	GAUGE	0
http.handler.timings: http_handler=handler-inspect-requests, http_path=/service/inspect-requests, percentile=p99_9, version=2	GAUGE	0
http.handler.timings: http_handler=handler-jemalloc, http_path=/service/jemalloc/prof/_command_, percentile=p0, version=2	GAUGE	0
http.handler.timings: http_handler=handler-jemalloc, http_path=/service/jemalloc/prof/_command_, percentile=p100, version=2	GAUGE	0
http.handler.timings: http_handler=handler-jemalloc, http_path=/service/jemalloc/prof/_command_, percentile=p50, version=2	GAUGE	0
http.handler.timings: http_handler=handler-jemalloc, http_path=/service/jemalloc/prof/_command_, percentile=p90, version=2	GAUGE	0
http.handler.timings: http_handler=handler-jemalloc, http_path=/service/jemalloc/prof/_command_, percentile=p95, version=2	GAUGE	0
http.handler.timings: http_handler=handler-jemalloc, http_path=/service/jemalloc/prof/_command_, percentile=p98, version=2	GAUGE	0
http.handler.timings: http_handler=handler-jemalloc, http_path=/service/jemalloc/prof/_command_, percentile=p99, version=2	GAUGE	0
http.handler.timings: http_handler=handler-jemalloc, http_path=/service/jemalloc/prof/_command_, percentile=p99_6, version=2	GAUGE	0
http.handler.timings: http_handler=handler-jemalloc, http_path=/service/jemalloc/prof/_command_, percentile=p99_9, version=2	GAUGE	0
http.handler.timings: http_handler=handler-log-level, http_path=/service/log-level/_level_, percentile=p0, version=2	GAUGE	0
http.handler.timings: http_handler=handler-log-level, http_path=/service/log-level/_level_, percentile=p100, version=2	GAUGE	0
http.handler.timings: http_handler=handler-log-level, http_path=/service/log-level/_level_, percentile=p50, version=2	GAUGE	0
http.handler.timings: http_handler=handler-log-level, http_path=/service/log-level/_level_, percentile=p90, version=2	GAUGE	0
http.handler.timings: http_handler=handler-log-level, http_path=/service/log-level/_level_, percentile=p95, version=2	GAUGE	0
http.handler.timings: http_handler=handler-log-level, http_path=/service/log-level/_level_, percentile=p98, version=2	GAUGE	0
http.handler.timings: http_handler=handler-log-level, http_path=/service/log-level/_level_, percentile=p99, version=2	GAUGE	0
http.handler.timings: http_handler=handler-log-level, http_path=/service/log-level/_level_, percentile=p99_6, version=2	GAUGE	0
http.handler.timings: http_handler=handler-log-level, http_path=/service/log-level/_level_, percentile=p99_9, version=2	GAUGE	0
http.handler.timings: http_handler=handler-on-log-rotate, http_path=/service/on-log-rotate/, percentile=p0, version=2	GAUGE	0
http.handler.timings: http_handler=handler-on-log-rotate, http_path=/service/on-log-rotate/, percentile=p100, version=2	GAUGE	0
http.handler.timings: http_handler=handler-on-log-rotate, http_path=/service/on-log-rotate/, percentile=p50, version=2	GAUGE	0
http.handler.timings: http_handler=handler-on-log-rotate, http_path=/service/on-log-rotate/, percentile=p90, version=2	GAUGE	0
http.handler.timings: http_handler=handler-on-log-rotate, http_path=/service/on-log-rotate/, percentile=p95, version=2	GAUGE	0
http.handler.timings: http_handler=handler-on-log-rotate, http_path=/service/on-log-rotate/, percentile=p98, version=2	GAUGE	0
http.handler.timings: http_handler=handler-on-log-rotate, http_path=/service/on-log-rotate/, percentile=p99, version=2	GAUGE	0
http.handler.timings: http_handler=handler-on-log-rotate, http_path=/service/on-log-rotate/, percentile=p99_6, version=2	GAUGE	0
http.handler.timings: http_handler=handler-on-log-rotate, http_path=/service/on-log-rotate/, percentile=p99_9, version=2	GAUGE	0
http.handler.timings: http_handler=handler-ping, http_path=/ping, percentile=p0, version=2	GAUGE	0
http.handler.timings: http_handler=handler-ping, http_path=/ping, percentile=p100, version=2	GAUGE	0
http.handler.timings: http_handler=handler-ping, http_path=/ping, percentile=p50, version=2	GAUGE	0
http.handler.timings: http_handler=handler-ping, http_path=/ping, percentile=p90, version=2	GAUGE	0
http.handler.timings: http_handler=handler-ping, http_path=/ping, percentile=p95, version=2	GAUGE	0
http.handler.timings: http_handler=handler-ping, http_path=/ping, percentile=p98, version=2	GAUGE	0
http.handler.timings: http_handler=handler-ping, http_path=/ping, percentile=p99, version=2	GAUGE	0
http.handler.timings: http_handler=handler-ping, http_path=/ping, percentile=p99_6, version=2	GAUGE	0
http.handler.timings: http_handler=handler-ping, http_path=/ping, percentile=p99_9, version=2	GAUGE	0
http.handler.timings: http_handler=handler-server-monitor, http_path=/service/monitor, percentile=p0, version=2	GAUGE	0
http.handler.timings: http_handler=handler-server-monitor, http_path=/service/monitor, percentile=p100, version=2	GAUGE	0
http.handler.timings: http_handler=handler-server-monitor, http_path=/service/monitor, percentile=p50, version=2	GAUGE	0
http.handler.timings: http_handler=handler-server-monitor, http_path=/service/monitor, percentile=p90, version=2	GAUGE	0
http.handler.timings: http_handler=handler-server-monitor, http_path=/service/monitor, percentile=p95, version=2	GAUGE	0
http.handler.timings: http_handler=handler-server-monitor, http_path=/service/monitor, percentile=p98, version=2	GAUGE	0
http.handler.timings: http_handler=handler-server-monitor, http_path=/service/monitor, percentile=p99, version=2	GAUGE	0
http.handler.timings: http_handler=handler-server-monitor, http_path=/service/monitor, percentile=p99_6, version=2	GAUGE	0
http.handler.timings: http_handler=handler-server-monitor, http_path=/service/monitor, percentile=p99_9, version=2	GAUGE	0
http.handler.timings: http_handler=tests-control, http_path=/tests/_action_, percentile=p0, version=2	GAUGE	0
http.handler.timings: http_handler=tests-control, http_path=/tests/_action_, percentile=p100, version=2	GAUGE	0
http.handler.timings: http_handler=tests-control, http_path=/tests/_action_, percentile=p50, version=2	GAUGE	0
http.handler.timings: http_handler=tests-control, http_path=/tests/_action_, percentile=p90, version=2	GAUGE	0
http.handler.timings: http_handler=tests-control, http_path=/tests/_action_, percentile=p95, version=2	GAUGE	0
http.handler.timings: http_handler=tests-control, http_path=/tests/_action_, percentile=p98, version=2	GAUGE	0
http.handler.timings: http_handler=tests-control, http_path=/tests/_action_, percentile=p99, version=2	GAUGE	0
http.handler.timings: http_handler=tests-control, http_path=/tests/_action_, percentile=p99_6, version=2	GAUGE	0
http.handler.timings: http_handler=tests-control, http_path=/tests/_action_, percentile=p99_9, version=2	GAUGE	0
http.handler.too-many-requests-in-flight: http_handler=handler-dns-client-control, http_path=/service/dnsclient/_command_, version=2	RATE	0
http.handler.too-many-requests-in-flight: http_handler=handler-dynamic-debug-log, http_path=/service/log/dynamic-debug, version=2	RATE	0
http.handler.too-many-requests-in-flight: http_handler=handler-inspect-requests, http_path=/service/inspect-requests, version=2	RATE	0
http.handler.too-many-requests-in-flight: http_handler=handler-jemalloc, http_path=/service/jemalloc/prof/_command_, version=2	RATE	0
http.handler.too-many-requests-in-flight: http_handler=handler-log-level, http_path=/service/log-level/_level_, version=2	RATE	0
http.handler.too-many-requests-in-flight: http_handler=handler-on-log-rotate, http_path=/service/on-log-rotate/, version=2	RATE	0
http.handler.too-many-requests-in-flight: http_handler=handler-ping, http_path=/ping, version=2	RATE	0
http.handler.too-many-requests-in-flight: http_handler=handler-server-monitor, http_path=/service/monitor, version=2	RATE	0
http.handler.too-many-requests-in-flight: http_handler=tests-control, http_path=/tests/_action_, version=2	RATE	0
http.handler.total.cancelled-by-deadline: version=2	RATE	0
http.handler.total.deadline-received: version=2	RATE	0
http.handler.total.in-flight: version=2	GAUGE	0
http.handler.total.rate-limit-reached: version=2	RATE	0
http.handler.total.reply-codes: http_code=200, version=2	RATE	0
http.handler.total.reply-codes: http_code=300, version=2	RATE	0
http.handler.total.reply-codes: http_code=500, version=2	RATE	0
http.handler.total.reply-codes: http_code=501, version=2	RATE	0
http.handler.total.rps: version=2	RATE	0
http.handler.total.timings: percentile=p0, version=2	GAUGE	0
http.handler.total.timings: percentile=p100, version=2	GAUGE	0
http.handler.total.timings: percentile=p50, version=2	GAUGE	0
http.handler.total.timings: percentile=p90, version=2	GAUGE	0
http.handler.total.timings: percentile=p95, version=2	GAUGE	0
http.handler.total.timings: percentile=p98, version=2	GAUGE	0
http.handler.total.timings: percentile=p99, version=2	GAUGE	0
http.handler.total.timings: percentile=p99_6, version=2	GAUGE	0
http.handler.total.timings: percentile=p99_9, version=2	GAUGE	0
http.handler.total.too-many-requests-in-flight: version=2	RATE	0
httpclient.cancelled-by-deadline: version=2	RATE	0
httpclient.cancelled-by-deadline: http_destination=http://localhost:00000/configs-service/configs/values, version=2	RATE	0
httpclient.errors: http_destination=http://localhost:00000/configs-service/configs/values, http_error=cancelled, version=2	RATE	0
httpclient.errors: http_destination=http://localhost:00000/configs-service/configs/values, http_error=host-resolution-failed, version=2	RATE	0
httpclient.errors: http_destination=http://localhost:00000/configs-service/configs/values, http_error=ok, version=2	RATE	0
httpclient.errors: http_destination=http://localhost:00000/configs-service/configs/values, http_error=socket-error, version=2	RATE	0
httpclient.errors: http_destination=http://localhost:00000/configs-service/configs/values, http_error=ssl-error, version=2	RATE	0
httpclient.errors: http_destination=http://localhost:00000/configs-service/configs/values, http_error=timeout, version=2	RATE	0
httpclient.errors: http_destination=http://localhost:00000/configs-service/configs/values, http_error=too-many-redirects, version=2	RATE	0
httpclient.errors: http_destination=http://localhost:00000/configs-service/configs/values, http_error=unknown-error, version=2	RATE	0
httpclient.errors: http_error=cancelled, version=2	RATE	0
httpclient.errors: http_error=host-resolution-failed, version=2	RATE	0
httpclient.errors: http_error=ok, version=2	RATE	0
httpclient.errors: http_error=socket-error, version=2	RATE	0
httpclient.errors: http_error=ssl-error, version=2	RATE	0
httpclient.errors: http_error=timeout, version=2	RATE	0
httpclient.errors: http_error=too-many-redirects, version=2	RATE	0
httpclient.errors: http_error=unknown-error, version=2	RATE	0
httpclient.event-loop-load.1min: version=2	GAUGE	0
httpclient.last-time-to-start-us: version=2	GAUGE	0
httpclient.pending-requests: version=2	GAUGE	0
httpclient.pending-requests: http_destination=http://localhost:00000/configs-service/configs/values, version=2	GAUGE	0
httpclient.reply-statuses: http_code=200, version=2	RATE	0
httpclient.reply-statuses: http_code=200, http_destination=http://localhost:00000/configs-service/configs/values, version=2	RATE	0
httpclient.reply-statuses: http_code=300, version=2	RATE	0
httpclient.reply-statuses: http_code=300, http_destination=http://localhost:00000/configs-service/configs/values, version=2	RATE	0
httpclient.reply-statuses: http_code=500, version=2	RATE	0
httpclient.reply-statuses: http_code=500, http_destination=http://localhost:00000/configs-service/configs/values, version=2	RATE	0
httpclient.reply-statuses: http_code=501, version=2	RATE	0
httpclient.reply-statuses: http_code=501, http_destination=http://localhost:00000/configs-service/configs/values, version=2	RATE	0
httpclient.retries: version=2	RATE	0
httpclient.retries: http_destination=http://localhost:00000/configs-service/configs/values, version=2	RATE	0
httpclient.sockets.active: version=2	RATE	0
httpclient.sockets.close: version=2	RATE	0
httpclient.sockets.open: version=2	RATE	0
httpclient.sockets.open: http_destination=http://localhost:00000/configs-service/configs/values, version=2	RATE	0
httpclient.sockets.throttled: version=2	RATE	0
httpclient.timeout-updated-by-deadline: version=2	RATE	0
httpclient.timeout-updated-by-deadline: http_destination=http://localhost:00000/configs-service/configs/values, version=2	RATE	0
httpclient.timings: http_destination=http://localhost:00000/configs-service/configs/values, percentile=p0, version=2	GAUGE	0
httpclient.timings: http_destination=http://localhost:00000/configs-service/configs/values, percentile=p100, version=2	GAUGE	0
httpclient.timings: http_destination=http://localhost:00000/configs-service/configs/values, percentile=p50, version=2	GAUGE	0
httpclient.timings: http_destination=http://localhost:00000/configs-service/configs/values, percentile=p90, version=2	GAUGE	0
httpclient.timings: http_destination=http://localhost:00000/configs-service/configs/values, percentile=p95, version=2	GAUGE	0
httpclient.timings: http_destination=http://localhost:00000/configs-service/configs/values, percentile=p98, version=2	GAUGE	0
httpclient.timings: http_destination=http://localhost:00000/configs-service/configs/values, percentile=p99, version=2	GAUGE	0
httpclient.timings: http_destination=http://localhost:00000/configs-service/configs/values, percentile=p99_6, version=2	GAUGE	0
httpclient.timings: http_destination=http://localhost:00000/configs-service/configs/values, percentile=p99_9, version=2	GAUGE	0
httpclient.timings: percentile=p0, version=2	GAUGE	0
httpclient.timings: percentile=p100, version=2	GAUGE	0
httpclient.timings: percentile=p50, version=2	GAUGE	0
httpclient.timings: percentile=p90, version=2	GAUGE	0
httpclient.timings: percentile=p95, version=2	GAUGE	0
httpclient.timings: percentile=p98, version=2	GAUGE	0
httpclient.timings: percentile=p99, version=2	GAUGE	0
httpclient.timings: percentile=p99_6, version=2	GAUGE	0
httpclient.timings: percentile=p99_9, version=2	GAUGE	0
io_read_bytes:	GAUGE	0
io_write_bytes:	GAUGE	0
logger.by_level: level=critical, logger=default	RATE	0
logger.by_level: level=debug, logger=default	RATE	0
logger.by_level: level=error, logger=default	RATE	0
logger.by_level: level=info, logger=default	RATE	0
logger.by_level: level=none, logger=default	RATE	0
logger.by_level: level=trace, logger=default	RATE	0
logger.by_level: level=warning, logger=default	RATE	0
logger.dropped: logger=default, version=2	RATE	0
logger.total: logger=default	RATE	0
logger.has_reopening_error: logger=default	GAUGE	0
major_pagefaults:	GAUGE	0
open_files:	GAUGE	0
rss_kb:	GAUGE	0
server.connections.active:	GAUGE	0
server.connections.closed:	GAUGE	0
server.connections.opened:	GAUGE	0
server.requests.active:	GAUGE	0
server.requests.avg-lifetime-ms:	GAUGE	0
server.requests.parsing:	GAUGE	0
server.requests.processed:	GAUGE	0
